SFW - Safe For Work Functions
Usage : akaneko.neko()
NEKO - CUTE ANIME SFW PICTURE
SFWFOXES - CUTE FOX ANIME SFW GIRL
WALLPAPERS - ANIME SFW WALLPAPER
MOBILEWALLPAPERS - ANIME WALLPAPER FOR MOBILE

NSFW - Not Safe For Work
Usage : akaneko.nsfw.bdsm()
BDSM - DON'T ASK ME WHAT IT IS. ASK GOOGLE.
CUM - DON'T ASK ME
DOUJIN - MANGA BUT NSFW STYLE
FEMDOM - TORTURE AND PLEASURE..?
HENTAI - YOU ALREADY KNOW IT...
MAID - ANIME MAID NSFW ( ͡° ͜ʖ ͡°)
ORGY - I DON'T KNOW ABOUT THIS NGL
PANTIES - PANTSU NSFW PIC ( ͡° ͜ʖ ͡°)
WALLPAPER - NSFW ANIME WALLPAPER ( ͡° ͜ʖ ͡°)
MOBILEWALLPAPERS - NSFW MOBILE ANIME WALLPAPERS ( ͡° ͜ʖ ͡°)
CUCKHOLD - PLEASURE..?
NETORARE - ^^^^^^^^^^^
GIFS / GIF - NSFW GIFS ( ͡° ͜ʖ ͡°)
BLOWJOB - YOU ALREADY KNOW WHAT IS THIS ( ͡° ͜ʖ ͡°)
FEET - ...
PUSSY - ...
UGLYBASTARD - UGLYBASTARD NSFW PIC
UNIFORM - NSFW UNIFORM PIC ( ͡° ͜ʖ ͡°)
GANGBANG - 3 OR MORE GUY AND 1 GIRL ( ͡° ͜ʖ ͡°)
FOXGIRL - NSFW FOX GIRL PICTURES ( ͡° ͜ʖ ͡°)
CUMSLUT - NSFW SLUT PICTURE ( ͡° ͜ʖ ͡°)
GLASSES - NSFW ANIME GLASSES ( ͡° ͜ʖ ͡°)
THIGHS - YOU ALREADY KNOW WHAT IS THIS ( ͡° ͜ʖ ͡°)
TENTACLES - ( ͡° ͜ʖ ͡°)
LOLI - FBI OPEN UP!
MASTURBATION - ( ͡° ͜ʖ ͡°)
SCHOOL - ( ͡° ͜ʖ ͡°)
YURI - GIRLS ON TOP OF EACHOTHER ( ͡° ͜ʖ ͡°)
ZETTAIRYOUIKI - I STILL DON'T UNDERSTAND JAPANESE, SOOOO IDK